MODE 3
SIZE 9/7
LIMIT 0/20
COLOR LIMIT 4
STARS 5000/6500/8000
COLLECT COUNT 0/0
COLLECT ITEMS 0/0
10 10 10 10 10 10 10 10 10
10 10 10 10 10 10 10 10 10
10 10 10 23 23 23 10 10 10
10 10 10 24 24 24 10 10 10
10 10 24 24 24 24 24 10 10
10 24 24 24 24 24 24 24 10
24 24 24 24 24 24 24 24 24