MODE 3
SIZE 9/11
LIMIT 0/48
COLOR LIMIT 5
STARS 5000/8500/11000
COLLECT COUNT 0/0
COLLECT ITEMS 0/0
00 20 20 20 20 00 06 50 50
20 20 20 20 20 20 06 50 50
20 20 20 20 20 20 00 50 50
20 20 20 20 20 20 00 50 50
20 20 20 20 20 20 00 50 50
20 20 20 20 20 20 00 50 50
20 20 20 20 20 20 00 50 50
20 20 20 20 20 20 00 50 50
20 20 20 20 20 20 00 50 50
20 20 20 20 20 20 00 50 50
00 20 20 20 20 00 00 50 50