MODE 2
SIZE 9/10
LIMIT 0/18
COLOR LIMIT 4
STARS 1000/2500/3800
COLLECT COUNT 3/1
COLLECT ITEMS 1/2
10 10 10 10 10 10 10 10 10
10 10 10 10 10 10 10 10 10
10 10 10 10 10 10 10 10 10
10 10 10 10 10 10 10 10 10
10 10 10 10 10 10 10 10 10
10 10 10 10 10 10 10 10 10
10 10 10 10 10 10 10 10 10
10 10 10 10 10 10 10 10 10
16 10 10 10 16 10 10 10 16
16 16 10 16 16 16 10 16 16