MODE 2
SIZE 9/9
LIMIT 0/41
COLOR LIMIT 5
STARS 1000/2500/3800
COLLECT COUNT 1/0
COLLECT ITEMS 1/0
14 14 14 14 10 14 14 14 14
14 14 14 10 10 10 14 14 14
14 14 10 10 10 10 10 14 14
14 10 10 10 10 10 10 10 14
17 10 10 10 16 10 10 10 17
16 10 10 10 10 10 10 10 16
16 16 10 10 10 10 10 16 16
16 16 16 10 10 10 16 16 16
16 16 16 16 17 16 16 16 16