MODE 2
SIZE 9/6
LIMIT 0/30
COLOR LIMIT 4
STARS 800/1300/1950
COLLECT COUNT 0/4
COLLECT ITEMS 1/2
10 10 10 10 10 00 10 10 10
10 10 10 10 10 00 10 10 10
10 10 10 10 10 00 10 10 10
10 10 10 10 10 00 10 10 10
16 14 14 14 14 00 14 14 14
16 16 14 14 14 00 14 14 16