MODE 3
SIZE 9/11
LIMIT 0/40
COLOR LIMIT 4
STARS 5300/8500/11000
COLLECT COUNT 0/0
COLLECT ITEMS 1/2
50 50 50 50 50 50 50 50 50
16 50 16 50 16 50 16 50 16
50 16 50 16 50 16 50 16 50
16 50 16 50 16 50 16 50 16
50 16 50 16 50 16 50 16 50
10 10 10 10 10 10 10 10 10
20 20 20 20 20 20 20 20 20
20 20 20 20 20 20 20 20 20
20 20 20 20 20 20 20 20 20
20 20 20 20 20 20 20 20 20
20 20 20 20 20 20 20 20 20