MODE 3
SIZE 9/9
LIMIT 1/150
COLOR LIMIT 4
STARS 1200/4900/6800
COLLECT COUNT 0/0
COLLECT ITEMS 1/2
00 00 00 00 00 00 00 00 00
00 00 20 20 20 20 20 00 00
00 20 20 50 50 50 20 20 00
00 20 50 50 16 50 50 20 00
00 20 50 16 50 16 50 20 00
00 20 50 50 16 50 50 20 00
00 20 20 50 50 50 20 20 00
00 00 20 20 20 20 20 00 00
00 00 00 00 00 00 00 00 00