MODE 3
SIZE 9/11
LIMIT 0/35
COLOR LIMIT 5
STARS 300/500/1300
COLLECT COUNT 0/0
COLLECT ITEMS 0/0
00 00 10 10 10 10 10 00 00
00 00 13 13 13 13 13 00 00
00 00 10 10 10 10 10 00 00
24 24 10 10 10 10 10 24 24
10 24 24 24 24 24 24 24 10
10 00 24 24 24 24 24 00 10
10 00 13 13 13 13 13 00 10
10 00 10 10 10 10 10 00 10
24 24 10 10 10 10 10 24 24
00 24 24 24 24 24 24 24 00
00 00 24 24 24 24 24 00 00