MODE 1
SIZE 9/9
LIMIT 1/90
COLOR LIMIT 5
STARS 1000/2500/3800
COLLECT COUNT 25/35
COLLECT ITEMS 2/3
10 10 10 10 10 10 14 17 14
10 10 10 10 10 14 17 14 14
10 10 10 10 14 17 14 14 13
10 10 10 14 17 14 14 13 13
10 10 14 17 14 14 13 13 13
10 14 17 14 14 13 13 13 13
14 17 14 14 13 13 13 13 03
17 14 14 13 13 13 13 00 00
14 14 13 13 13 13 00 00 00