MODE 1
SIZE 9/11
LIMIT 1/90
COLOR LIMIT 5
STARS 1000/2500/3800
COLLECT COUNT 120/120
COLLECT ITEMS 2/5
00 10 10 10 00 10 10 10 00
10 10 10 10 10 10 10 10 10
10 10 10 10 10 10 10 10 10
10 10 10 10 10 10 10 10 10
14 10 10 10 10 10 10 10 14
14 14 10 10 10 10 10 14 14
14 14 14 10 10 10 14 14 14
14 14 14 14 10 14 14 14 14
14 14 14 14 14 14 14 14 14
14 14 14 14 14 14 14 14 14
14 14 14 14 14 14 14 14 14