MODE 2
SIZE 8/8
LIMIT 0/25
COLOR LIMIT 4
STARS 1000/2500/3800
COLLECT COUNT 0/3
COLLECT ITEMS 0/2
10 10 10 10 10 10 10 10
10 10 10 10 10 10 10 10
10 10 16 10 10 10 10 10
10 10 10 10 10 10 16 16
10 10 10 10 10 10 10 10
10 16 10 10 10 10 10 10
16 16 10 16 10 16 10 10
10 10 10 16 16 16 10 10