MODE 3
SIZE 9/11
LIMIT 0/27
COLOR LIMIT 5
STARS 360/5800/7500
COLLECT COUNT 0/0
COLLECT ITEMS 1/2
10 10 10 10 10 10 00 50 50
10 10 10 10 10 10 00 00 00
00 00 00 10 10 10 10 10 10
50 50 00 10 10 10 10 10 10
50 50 00 10 10 10 10 10 10
50 50 00 10 10 10 10 10 10
00 00 00 10 10 10 10 10 10
10 10 10 10 10 10 10 10 10
10 10 10 10 10 10 10 10 10
10 10 10 10 10 10 00 00 00
10 10 10 10 10 10 00 50 50