MODE 2
SIZE 9/9
LIMIT 0/35
COLOR LIMIT 5
STARS 2500/4100/6210
COLLECT COUNT 2/2
COLLECT ITEMS 1/2
10 10 10 10 10 10 10 10 10
10 10 10 10 10 10 10 10 10
10 10 10 10 10 10 10 10 10
10 10 10 10 10 10 10 10 10
10 10 10 10 10 10 10 10 10
10 10 10 10 10 10 10 10 10
16 14 14 14 14 14 14 14 14
16 14 16 14 14 14 14 14 14
16 16 16 16 16 14 14 14 14