MODE 0
SIZE 9/9
LIMIT 0/19
COLOR LIMIT 5
STARS 1300/1810/2020
COLLECT COUNT 0/0
COLLECT ITEMS 0/0
00 10 10 00 00 00 10 10 00
10 10 10 10 00 10 10 10 10
10 10 10 10 10 10 10 10 10
10 10 10 10 10 10 10 10 10
00 10 10 10 10 10 10 10 00
00 10 10 10 10 10 10 10 00
00 00 10 10 10 10 10 00 00
00 00 00 00 10 00 00 00 00
00 00 00 00 00 00 00 00 00