MODE 1
SIZE 9/9
LIMIT 0/27
COLOR LIMIT 6
STARS 2750/4500/5900
COLLECT COUNT 25/30
COLLECT ITEMS 4/5
13 13 13 17 17 17 13 10 13
10 13 10 17 10 17 13 13 10
10 13 10 17 10 17 13 13 10
10 13 10 17 17 17 13 10 13
13 10 10 10 13 14 14 14 14
10 13 10 13 10 14 10 10 14
10 10 13 10 10 14 10 10 14
10 10 13 10 10 14 10 10 14
10 10 13 10 10 14 14 14 14