MODE 3
SIZE 9/11
LIMIT 0/15
COLOR LIMIT 5
STARS 2900/3900/4900
COLLECT COUNT 0/0
COLLECT ITEMS 0/0
10 10 10 10 00 10 10 10 10
10 20 20 10 00 10 20 20 10
10 20 20 10 00 10 20 20 10
10 20 20 10 00 10 20 20 10
10 10 10 10 00 10 10 10 10
00 00 00 00 00 00 00 00 00
10 10 10 10 00 10 10 10 10
10 20 20 10 00 10 20 20 10
10 20 20 10 00 10 20 20 10
10 20 20 10 00 10 20 20 10
10 10 10 10 00 10 10 10 10