MODE 0
SIZE 9/11
LIMIT 0/40
COLOR LIMIT 6
STARS 6800/7100/7300
COLLECT COUNT 0/0
COLLECT ITEMS 1/2
10 10 10 10 10 10 10 10 10
10 10 10 10 10 10 10 10 10
10 10 10 10 10 10 10 10 10
10 10 10 10 17 10 10 10 10
10 10 10 10 10 10 10 10 10
10 10 10 10 10 10 10 10 10
10 10 10 10 10 10 10 10 10
13 14 13 14 13 14 13 14 13
14 13 14 13 14 13 14 13 14
10 10 10 10 10 10 10 10 10
10 10 10 10 10 10 10 10 10