MODE 3
SIZE 9/9
LIMIT 0/30
COLOR LIMIT 5
STARS 9500/15000/21000
COLLECT COUNT 0/0
COLLECT ITEMS 1/2
23 10 10 10 10 10 10 16 20
10 23 10 10 10 10 10 23 16
10 10 23 10 10 10 23 10 10
10 10 10 23 10 23 10 10 10
10 10 10 10 23 10 10 10 10
10 10 10 23 10 23 10 10 10
10 10 23 10 10 10 16 16 16
16 23 10 10 10 10 16 20 16
20 16 10 10 10 10 16 16 16