MODE 3
SIZE 9/11
LIMIT 0/30
COLOR LIMIT 5
STARS 7000/8000/9000
COLLECT COUNT 0/0
COLLECT ITEMS 1/2
10 10 10 10 10 13 10 13 10
10 10 10 10 13 10 13 10 13
10 10 10 10 10 13 10 13 10
10 10 10 10 13 10 13 10 13
10 13 10 13 10 13 10 13 10
13 10 13 10 13 10 13 10 13
14 23 14 23 14 23 14 23 14
23 14 23 14 23 14 23 14 23
14 23 14 23 14 23 14 23 14
23 14 23 14 23 14 23 14 23
14 23 14 23 14 23 14 23 14