MODE 2
SIZE 9/9
LIMIT 0/40
COLOR LIMIT 5
STARS 2200/2210/2
COLLECT COUNT 1/1
COLLECT ITEMS 1/2
00 00 13 00 13 00 13 00 00
00 00 10 00 10 00 10 00 00
00 00 10 00 10 00 10 00 00
10 10 10 10 10 10 10 10 10
10 14 14 10 10 10 14 14 10
10 10 10 10 10 10 10 10 10
14 14 16 10 14 10 16 14 14
00 00 16 10 14 10 16 00 00
00 00 06 16 14 16 00 00 00