MODE 3
SIZE 9/11
LIMIT 0/50
COLOR LIMIT 5
STARS 1000/2000/3000
COLLECT COUNT 0/0
COLLECT ITEMS 0/0
20 20 14 14 14 20 23 23 23
00 20 14 00 14 20 23 00 23
20 20 14 00 14 20 23 23 23
20 00 14 00 14 20 23 00 23
20 20 14 14 14 20 23 23 23
00 00 00 00 00 00 00 00 00
10 10 10 10 10 10 10 10 10
10 10 10 10 10 10 10 10 10
10 10 10 10 10 10 10 10 10
10 10 10 10 10 10 10 10 10
10 10 10 10 10 10 10 10 10