MODE 3
SIZE 9/11
LIMIT 0/33
COLOR LIMIT 5
STARS 5900/6800/9700
COLLECT COUNT 0/0
COLLECT ITEMS 0/0
00 00 00 00 20 00 00 00 00
00 00 00 20 20 20 00 50 00
00 00 20 20 20 20 20 16 00
00 20 20 20 20 20 20 26 00
20 20 20 20 20 20 20 20 20
00 14 14 14 14 14 14 14 00
00 14 10 10 14 14 14 14 00
00 14 10 10 14 14 14 14 00
00 14 14 14 14 14 14 14 00
00 00 00 00 00 00 00 00 00
00 00 00 00 00 00 00 00 00