MODE 3
SIZE 9/9
LIMIT 1/55
COLOR LIMIT 5
STARS 8500/9600/11200
COLLECT COUNT 0/0
COLLECT ITEMS 0/0
54 16 14 10 10 10 10 10 10
16 17 13 10 10 10 10 10 10
54 54 16 10 10 10 10 10 10
16 13 14 10 10 10 10 10 10
54 54 17 10 10 10 10 10 10
16 54 14 10 10 10 10 10 10
54 13 54 10 10 10 10 10 10
16 17 16 10 10 10 10 10 10
54 14 54 10 10 10 10 10 10