MODE 2
SIZE 9/9
LIMIT 1/162
COLOR LIMIT 6
STARS 3900/4600/5800
COLLECT COUNT 2/2
COLLECT ITEMS 1/2
10 10 10 10 10 10 10 10 10
10 10 10 10 10 10 10 10 10
10 10 10 10 10 10 10 10 10
10 10 10 10 10 10 10 10 10
10 13 10 13 10 13 10 13 10
13 13 13 13 13 13 13 13 13
13 13 13 13 13 13 13 13 13
13 13 13 13 13 13 13 13 13
13 13 13 13 13 13 13 13 13