MODE 0
SIZE 9/10
LIMIT 1/90
COLOR LIMIT 5
STARS 10000/11010/12020
COLLECT COUNT 0/0
COLLECT ITEMS 0/0
10 10 10 10 10 10 10 10 10
10 10 10 10 10 10 10 10 10
10 10 10 10 10 10 10 10 10
10 10 10 10 10 10 10 10 10
13 13 13 13 13 13 13 13 13
17 13 17 17 13 17 17 13 17
17 13 17 17 13 17 17 13 17
13 13 13 13 13 13 13 13 13
17 13 17 17 13 17 17 13 17
17 13 17 17 13 17 17 13 17