MODE 2
SIZE 9/10
LIMIT 0/23
COLOR LIMIT 5
STARS 3200/4500/5700
COLLECT COUNT 1/2
COLLECT ITEMS 1/2
10 10 10 10 10 10 10 10 10
10 10 10 10 10 10 10 10 10
10 10 10 10 10 10 10 10 10
13 10 10 10 10 10 10 10 13
00 13 10 10 10 10 10 13 00
10 00 13 10 10 10 13 00 10
10 10 00 13 13 13 00 10 10
10 10 10 00 00 00 10 10 10
10 10 10 10 10 10 10 10 10
13 13 13 13 13 13 13 13 13