MODE 3
SIZE 9/10
LIMIT 0/23
COLOR LIMIT 4
STARS 10000/12500/14000
COLLECT COUNT 0/0
COLLECT ITEMS 1/2
13 00 20 20 20 20 20 00 13
00 00 20 20 20 20 20 00 00
13 20 20 20 20 20 20 20 13
13 20 20 00 00 00 20 20 13
13 20 20 00 50 00 20 20 13
13 20 20 00 00 00 20 20 13
13 20 20 20 20 20 20 20 13
13 20 20 20 20 20 20 20 13
00 00 20 20 20 20 20 00 00
13 00 20 20 20 20 20 00 13