MODE 3
SIZE 9/9
LIMIT 0/28
COLOR LIMIT 5
STARS 4800/5800/6900
COLLECT COUNT 0/0
COLLECT ITEMS 1/2
00 20 20 16 50 16 20 20 00
20 00 10 10 16 10 10 00 20
20 10 14 10 10 10 14 10 20
16 10 10 14 10 14 10 10 16
50 16 10 10 14 10 10 16 50
16 10 10 14 10 14 10 10 16
20 10 14 10 10 10 14 10 20
20 00 10 10 16 10 10 00 20
00 20 20 16 50 16 20 20 00