MODE 3
SIZE 9/9
LIMIT 0/30
COLOR LIMIT 6
STARS 2200/3200/4500
COLLECT COUNT 0/0
COLLECT ITEMS 0/0
00 10 10 10 10 10 10 10 00
10 10 10 10 10 10 10 10 10
10 10 10 10 10 10 10 10 10
00 10 10 50 50 50 10 10 00
00 00 00 50 50 50 00 00 00
00 00 00 27 27 27 00 00 00
00 00 27 27 27 27 27 00 00
00 57 57 27 27 27 17 27 00
27 27 27 27 27 27 27 27 27