MODE 3
SIZE 9/11
LIMIT 0/21
COLOR LIMIT 6
STARS 1500/2900/3600
COLLECT COUNT 0/0
COLLECT ITEMS 0/0
10 10 10 10 00 10 10 10 10
10 10 10 10 00 10 10 10 10
10 10 10 10 00 10 10 10 10
10 10 20 20 20 20 20 10 10
00 00 20 53 53 53 20 00 00
00 00 20 53 53 53 20 00 00
10 10 20 20 20 20 20 10 10
10 10 10 10 10 10 10 10 10
10 10 10 10 00 10 10 10 10
10 10 10 10 00 10 10 10 10
10 10 10 10 00 10 10 10 10