MODE 3
SIZE 9/11
LIMIT 0/21
COLOR LIMIT 5
STARS 1000/1600/2200
COLLECT COUNT 0/0
COLLECT ITEMS 0/0
10 10 10 10 10 10 10 10 10
10 10 10 10 10 10 10 10 10
10 10 10 14 24 14 10 10 10
10 10 14 14 24 14 14 10 10
10 14 17 17 24 17 17 14 10
10 24 24 24 24 24 24 24 10
10 14 14 14 24 14 14 14 10
10 10 14 17 27 17 14 10 10
10 10 10 14 24 14 10 10 10
10 10 10 10 10 10 10 10 10
10 10 10 10 10 10 10 10 10