MODE 3
SIZE 9/9
LIMIT 0/38
COLOR LIMIT 5
STARS 9800/11300/13500
COLLECT COUNT 0/0
COLLECT ITEMS 1/2
50 00 10 10 00 10 10 00 50
00 00 10 10 10 10 10 00 00
10 10 10 10 10 10 10 10 10
10 10 10 10 10 10 10 10 10
00 10 10 10 00 10 10 10 00
10 10 10 10 10 10 10 10 10
10 10 10 10 10 10 10 10 10
00 00 10 10 10 10 10 00 00
50 00 10 10 00 10 10 00 50