MODE 3
SIZE 9/11
LIMIT 0/28
COLOR LIMIT 5
STARS 1000/2500/3800
COLLECT COUNT 0/0
COLLECT ITEMS 0/0
00 10 10 10 10 10 10 10 00
10 10 10 10 10 10 10 10 10
10 10 10 10 10 10 10 10 10
10 10 10 10 10 10 10 10 10
14 14 14 14 14 14 14 14 14
14 14 14 14 14 14 14 14 14
00 00 00 00 10 00 00 00 00
10 17 17 17 17 17 17 17 10
10 17 50 50 50 50 50 17 10
10 17 50 50 50 50 50 17 10
00 17 17 17 17 17 17 17 00