MODE 3
SIZE 9/10
LIMIT 0/30
COLOR LIMIT 5
STARS 1000/2500/3800
COLLECT COUNT 0/0
COLLECT ITEMS 0/0
20 20 00 00 20 14 10 10 10
20 20 00 00 14 14 10 10 10
00 00 20 20 00 00 10 10 10
00 00 20 20 00 00 10 10 10
20 20 00 00 14 14 10 10 10
20 20 00 00 14 14 10 10 10
00 00 20 20 00 00 10 10 10
00 00 20 20 00 00 10 10 10
20 20 00 00 14 14 10 10 10
20 20 00 00 20 14 10 10 10