MODE 3
SIZE 9/9
LIMIT 1/60
COLOR LIMIT 4
STARS 2900/3600/4800
COLLECT COUNT 0/0
COLLECT ITEMS 0/0
20 00 50 00 50 00 50 00 20
00 00 00 00 00 00 00 00 00
20 00 50 00 50 00 50 00 20
00 00 00 00 00 00 00 00 00
00 10 10 10 10 10 10 10 00
00 10 10 10 10 10 10 10 00
00 10 10 10 10 10 10 10 00
00 10 10 10 10 10 10 10 00
00 10 10 10 10 10 10 10 00