MODE 0
SIZE 9/11
LIMIT 1/60
COLOR LIMIT 5
STARS 16000/17000/18000
COLLECT COUNT 0/0
COLLECT ITEMS 1/2
14 14 10 10 10 10 10 10 10
14 10 10 10 10 10 14 10 10
10 10 10 10 10 14 14 14 10
10 10 10 10 10 10 14 10 10
10 10 10 14 10 10 10 10 10
10 10 14 14 14 10 10 10 14
10 10 10 14 10 10 10 10 10
10 10 10 10 10 10 10 10 10
10 10 10 10 10 10 10 14 10
10 10 14 10 10 10 14 14 14
10 14 14 14 10 10 10 14 10