MODE 3
SIZE 9/9
LIMIT 0/45
COLOR LIMIT 5
STARS 1000/1550/2150
COLLECT COUNT 0/0
COLLECT ITEMS 0/0
50 50 50 00 13 13 13 13 13
50 50 50 00 13 13 13 13 13
50 50 50 00 13 13 13 13 13
00 00 00 20 13 13 13 13 13
10 10 10 10 13 13 13 13 13
10 10 10 10 10 20 00 00 00
10 10 10 10 10 00 50 50 50
10 10 10 10 10 00 50 50 50
10 10 10 10 10 00 50 50 50