MODE 2
SIZE 9/11
LIMIT 0/35
COLOR LIMIT 5
STARS 2500/3800/5600
COLLECT COUNT 2/2
COLLECT ITEMS 1/2
10 10 10 10 10 10 10 10 10
10 10 10 10 10 10 10 10 10
10 10 10 10 10 10 10 10 10
10 10 10 10 10 10 10 10 10
10 10 10 10 10 10 10 10 10
10 16 10 16 10 16 10 16 10
10 10 13 10 10 10 13 10 10
14 13 13 13 14 13 13 13 14
16 14 16 14 16 14 16 14 16
14 17 17 17 14 17 17 17 14
17 17 17 17 17 17 17 17 17