MODE 3
SIZE 9/10
LIMIT 0/32
COLOR LIMIT 5
STARS 3500/5500/7200
COLLECT COUNT 0/0
COLLECT ITEMS 1/2
50 27 10 10 17 10 10 14 50
16 14 10 10 10 10 10 17 16
10 10 10 10 00 10 10 10 10
10 10 10 10 10 10 10 10 10
00 00 10 10 17 10 10 00 00
00 00 10 10 17 10 10 00 00
10 10 10 10 10 10 10 10 10
10 10 10 10 10 10 10 10 10
17 13 10 10 10 10 10 16 14
50 16 10 10 17 10 10 17 50