MODE 0
SIZE 9/10
LIMIT 0/25
COLOR LIMIT 5
STARS 13500/14510/15520
COLLECT COUNT 0/0
COLLECT ITEMS 1/2
10 10 10 10 00 10 10 10 10
10 10 10 10 00 10 10 10 10
10 10 10 10 00 10 10 10 10
10 10 10 10 00 10 10 10 10
00 00 00 00 00 00 00 00 00
14 14 14 14 14 14 14 14 14
14 14 14 14 14 14 14 14 14
14 14 14 14 14 14 14 14 14
14 14 14 14 14 14 14 14 14
14 14 14 14 14 14 14 14 14