MODE 1
SIZE 9/11
LIMIT 0/29
COLOR LIMIT 4
STARS 2500/4500/4510
COLLECT COUNT 25/15
COLLECT ITEMS 4/3
00 00 10 10 10 10 10 00 10
00 10 10 10 10 10 00 10 10
10 10 10 10 10 00 10 10 10
10 10 10 10 16 10 10 10 10
10 10 10 16 10 10 10 10 16
10 10 16 10 10 10 10 16 17
17 00 10 10 10 10 16 10 10
00 10 10 10 10 00 10 10 10
10 10 10 10 16 10 10 10 10
10 10 10 16 10 10 10 10 00
10 10 16 10 10 10 10 00 00