MODE 2
SIZE 9/11
LIMIT 0/60
COLOR LIMIT 4
STARS 3000/4100/5600
COLLECT COUNT 2/2
COLLECT ITEMS 1/2
10 10 10 10 10 10 10 10 10
10 10 10 10 10 10 10 10 10
10 10 10 10 10 10 10 10 10
10 10 10 10 10 10 10 10 10
10 10 10 10 10 10 10 10 10
10 10 10 10 10 10 10 10 10
10 10 10 10 10 10 10 10 10
10 10 10 10 10 10 10 10 10
10 10 16 10 16 10 16 10 16
10 10 16 16 16 16 16 16 16
10 10 16 10 16 10 16 10 16