MODE 3
SIZE 9/11
LIMIT 0/43
COLOR LIMIT 5
STARS 10000/18000/27000
COLLECT COUNT 0/0
COLLECT ITEMS 1/2
10 10 10 10 10 10 10 10 10
10 10 10 10 10 10 10 10 10
10 10 10 23 10 10 10 10 23
10 10 23 10 23 10 10 23 23
17 23 23 23 53 10 17 53 23
17 23 23 23 53 17 17 23 23
17 23 23 13 17 17 17 23 23
17 17 23 17 17 23 17 17 23
23 17 17 17 23 23 23 17 17
23 23 17 23 23 23 23 17 17
23 23 17 17 23 23 23 17 17