MODE 3
SIZE 9/11
LIMIT 1/80
COLOR LIMIT 5
STARS 4500/5800/6900
COLLECT COUNT 0/0
COLLECT ITEMS 0/0
10 10 10 10 10 10 10 10 10
00 10 10 10 10 10 10 10 00
00 00 10 10 10 10 10 00 00
00 00 00 10 10 10 00 00 00
16 16 00 16 16 16 00 16 16
20 16 00 16 20 16 00 16 20
16 16 00 16 16 16 00 16 16
00 00 00 10 10 10 00 00 00
00 00 10 10 10 10 10 00 00
00 10 10 10 10 10 10 10 00
10 10 10 10 10 10 10 10 10