MODE 3
SIZE 9/11
LIMIT 0/51
COLOR LIMIT 4
STARS 8300/15000/28000
COLLECT COUNT 0/0
COLLECT ITEMS 0/0
14 20 14 00 00 00 14 20 14
20 14 20 00 00 00 20 14 20
14 20 14 00 00 00 14 20 14
20 14 20 00 00 00 20 14 20
14 20 14 00 00 00 14 20 14
20 50 20 00 00 00 20 50 20
50 20 50 00 00 00 50 20 50
20 50 20 00 00 00 20 50 20
50 20 50 16 16 16 50 20 50
20 50 20 16 20 16 20 50 20
50 20 50 16 16 16 50 20 50