MODE 3
SIZE 9/11
LIMIT 0/59
COLOR LIMIT 5
STARS 1000/2500/3800
COLLECT COUNT 0/0
COLLECT ITEMS 0/0
00 00 16 16 00 16 16 00 00
00 16 23 23 23 23 23 16 00
00 16 23 23 23 23 23 16 00
00 16 23 23 23 23 23 16 00
00 16 23 23 23 23 23 16 00
00 00 16 16 00 16 16 00 00
00 00 00 16 00 16 00 00 00
17 10 10 10 10 10 10 10 17
10 10 10 10 10 10 10 10 10
10 10 10 10 10 10 10 10 10
17 10 10 10 10 10 10 10 17