MODE 2
SIZE 9/11
LIMIT 0/40
COLOR LIMIT 5
STARS 4100/4800/5300
COLLECT COUNT 1/1
COLLECT ITEMS 1/2
10 10 10 10 10 10 10 10 16
10 10 10 10 10 10 10 16 16
10 10 10 16 10 10 10 10 10
10 10 16 16 16 10 10 10 10
10 10 10 10 10 10 10 10 10
10 10 10 10 10 16 10 10 10
10 10 10 10 16 16 16 10 10
10 16 10 10 10 10 10 10 10
16 16 16 10 10 10 10 16 10
10 10 10 10 10 10 16 16 16
10 10 10 10 10 10 10 10 10