MODE 0
SIZE 9/11
LIMIT 0/30
COLOR LIMIT 4
STARS 24000/25010/26020
COLLECT COUNT 0/0
COLLECT ITEMS 1/2
17 17 17 13 10 13 17 17 17
17 17 17 13 10 13 17 17 17
17 17 17 13 10 13 17 17 17
17 13 13 10 10 10 13 13 17
17 13 10 10 10 10 10 13 17
17 13 10 10 10 10 10 13 17
17 17 13 10 10 10 13 17 17
17 17 17 13 13 13 17 17 17
17 17 17 17 17 17 17 17 17
17 17 17 17 17 17 17 17 17
17 17 17 17 17 17 17 17 17